1111111111
1001000101
1010101011
1100111011
1010000101
1001111001
1111111111